######################################################################################################################################################
#                                                                                                                                                    #
#                                                                                                                                                    #
#                                                                                                                                                    #
#                                                                                                                                                    #
#                                                                                                                                                    #
#                                                                                                                                                    #
#                                                                                                                                                    #
#                                                                                                                                                    #
#                                                                                                                                                    #
#                                                                                                                                                    #
#                                                                                                                                                    #
#                                                                                                                                                    #
#                                                                                                                                                    #
#                                                                                                                                                    #
#                                                                                                                                                    #
#                                                                                                                                                    #
#                                                                                                                                                    #
#                              o                                                                                                                     #
#                                                                                                                                                    #
#                                                                                                                                                    #
#                                                                                                                                                    #
#                                                                                                                                                    #
#                                                                                                                                                    #
#                                                                                                                                                    #
#                                                                                                                                                    #
#                                                                                                                                                    #
#                                                                                                                                                    #
#                                                                                                                                                    #
#                                                                                                                                                    #
#                                                                                                                                                    #
#                                                                                                                                                    #
#                                                                                                                                                    #
#                                                                                                                                                    #
#                                                                                                                                                    #
#                                                                                                                                                    #
#                                                                                                                                                    #
######################################################################################################################################################

